0000000000000000000000000000000000000000
0000111111111111111111111111111111100000
0000011111111222222222222111111111110000
0000000111111222223222222221111110000000
0000011111111222233333322222111100000000
0000111111122222233343333222221111100000
0001111112222233334444433322222111000000
0000001111112222233333333332222211111100
0000000111111111222232222222111111110000
0000000000001111111222111111111000000000
0000000000000000011111111000000001111100
0000000000111111111000000000000011222110
0000001111122222221111111111101112232210
0000011122223333322222111111111222333210
0000011223333222221111100000122233332210
0000001122233211111111000000122333322110
0000000111232211111111110001122222221100
0000000111222111111111111011111111111000
0000000011111111111111111111111110000000
0000001111110001111112222221111111110000
0000111111100000111112223322211111111100
0000012222111111121111122221111111110000
0000011111100001111111111111111110000000
0000000000111111000000011111100000000000
0000000001122211000000012222100000000000
0000000001223221000000011111100000000000
0000000001122211000000000010000001111000
0000000000111110000000000000000011221000
0000000000001000000111110000000001121000
0000000000000000000111111000000000111000
0000000011111000111111110000000000000000
0001111111111111122222211100000000000000
0011222222111000123333221111100000000000
0001111111100000122222211100000000000000
0000000001000000111111110000000000111000
0000000000000000000000000000000111121100
0000000000000000000000000000001111111110
0111111111111111110000000000000000000000
0111111111111111111111100000000000000000
0000000000000000000000000000000000000000
